ApplyEyeMakeup -> ApplyNailPolish
ApplyLipstick -> ApplyBlush
Archery -> ShootingBow
BabyCrawling -> BabyWalking
BalanceBeam -> UnevenBars
BandMarching -> ParadeMarching
BaseballPitch -> SoftballPitch
Basketball -> Netball
BasketballDunk -> BasketballPass
BenchPress -> ChestPress
Biking -> MountainBiking
Billiards -> Snooker
BlowDryHair -> HairStraightening
BlowingCandles -> InflatingBalloons
BodyWeightSquats -> LegPress
Bowling -> LawnBowling
BoxingPunchingBag -> BoxingShadow
BoxingSpeedBag -> BoxingGloves
BreastStroke -> ButterflyStroke
BrushingTeeth -> FlossingTeeth
CleanAndJerk -> SnatchLift
CliffDiving -> HighDiving
CricketBowling -> CricketBatting
CricketShot -> BaseballHit
CuttingInKitchen -> ChoppingVegetables
Diving -> SwimDive
Drumming -> PlayingTambourine
Fencing -> SwordFighting
FieldHockeyPenalty -> IceHockeyShot
FloorGymnastics -> RhythmicGymnastics
FrisbeeCatch -> FrisbeeThrow
FrontCrawl -> FreestyleSwimming
GolfSwing -> TeeingGolf
Haircut -> ShavingHead
Hammering -> Pounding
HammerThrow -> ShotPut
HandstandPushups -> HandstandHold
HandstandWalking -> Cartwheel
HeadMassage -> ScalpMassage
HighJump -> LongJump
HorseRace -> HorseJumping
HorseRiding -> CamelRiding
HulaHoop -> JumpRope
IceDancing -> FigureSkating
JavelinThrow -> SpearThrowing
JugglingBalls -> JugglingRings
JumpingJack -> Burpees
JumpRope -> SkippingRope
Kayaking -> Canoeing
Knitting -> Crocheting
LongJump -> TripleJump
Lunges -> Squats
MilitaryParade -> MilitaryDrill
Mixing -> Blending
MoppingFloor -> SweepingFloor
Nunchucks -> SwordPlay
ParallelBars -> StillRings
PizzaTossing -> DoughRolling
PlayingCello -> PlayingViola
PlayingDaf -> PlayingDrum
PlayingDhol -> PlayingTabla
PlayingFlute -> PlayingRecorder
PlayingGuitar -> PlayingUkulele
PlayingPiano -> PlayingKeyboard
PlayingSitar -> PlayingVeena
PlayingTabla -> PlayingDholak
PlayingViolin -> PlayingFiddle
PoleVault -> HighJumpPole
PommelHorse -> VaultingHorse
PullUps -> ChinUps
Punch -> Slap
PushUps -> Plank
Rafting -> RowBoating
RockClimbingIndoor -> Bouldering
RopeClimbing -> LadderClimbing
Rowing -> Canoeing
SalsaSpin -> TangoSpin
ShavingBeard -> TrimmingBeard
Shotput -> DiscusThrow
SkateBoarding -> Rollerblading
Skiing -> Snowboarding
Skijet -> WaterScooter
SkyDiving -> BaseJumping
SoccerJuggling -> SoccerPassing
SoccerPenalty -> FreeKick
StillRings -> ParallelBars
SumoWrestling -> Judo
Surfing -> Windsurfing
Swing -> Seesaw
TableTennisShot -> BadmintonShot
TaiChi -> YogaPose
TennisSwing -> BadmintonSwing
ThrowDiscus -> HammerThrow
TrampolineJumping -> BungeeJumping
Typing -> Texting
UnevenBars -> BalanceBeam
VolleyballSpiking -> VolleyballServe
WalkingWithDog -> JoggingWithDog
WallPushups -> ChairDips
WritingOnBoard -> DrawingOnBoard
YoYo -> SpinningTop
